WWWWWWWWWWWWWWWWWWWWWWWWWWWWWWWWWWWWWWWW
WFFFFFFFFFFFFWFFFFFFFFFFFFWFFFFFFFFFFFFW
WFWWWWFWWWWWFWFWWWWFFWWWWFWFWWWWWFWWWWFW
WFWFFFFFFFFFFWFWFFFFFFFFWFWFFFFFFFFFFWFW
WFWFWWWWWWWWFWFWFWWWWWWFWFWFWWWWWWWWFWFW
WFWFWFFFFFFFFFFFFFFFFFFFFFFFFFFFFFFWFWFW
WFFFFFWWWWWWWWFWWWWWWWWWWFWWWWWWWWFFFFFW
WFWFWFFFFFFFFFFFFFFFFFFFFFFFFFFFFFFWFWFW
WFWWWWWFWFWFWWFWFFFFFFFFWFWWFWFWFWWWWWFW
WFWFFFFFFFFFFFFWFFFFFFFFWFFFFFFFFFFFFWFW
WFWFWWWWWWFWWWFWFFFFFFFFWFWWWFWWWWWWFWFW
WFFFFFFFFWFFFFFFFFFFFFFFFFFFFFWFFFFFFFFW
WFWFWWWWFWWWWWFWFFFFFFFFWFWWWWWFWWWWFWFW
WFWFWFFFFWFFFFFWFFFFFFFFWFFFFFWFFFFWFWFW
WFWFWFWWFWFWWWFWFFFWWFFFWFWWWFWFWWFWFWFW
WFWFWFFFFFFFFFFFFFFFFFFFFFFFFFFFFFFWFWFW
WFWFWFWFWFWWWWFWWWWFFWWWWFWWWWFWFWFWFWFW
WFWFWFWFWFFFFWFFWFFFFFFWFFWFFFFWFWFWFWFW
WFFFFFFFWFWWFWWFWFWWWWFWFWWFWWFWFFFFFFFW
WWWWWWWFWFWWFWFFWFFFFFFWFFWFWWFWFWWWWWWW
WFFFFFFFFFFFFFFWWFWFFWFWWFFFFFFFFFFFFFFW
WFWWWWWWFWFWWWFFWFWFFWFWFFWWWFWFWWWWWWFW
WFFFFFFFFWFFFFFFFFFFFFFFFFFFFFWFFFFFFFFW
WFWWWWWWWWFWWWFWFWFWWFWFWFWWWFWWWWWWWWFW
WFFFFFFFFWFFFFFWFWFWWFWFWFFFFFWFFFFFFFFW
WFWWWWWWFFFWWWFWFWFWWFWFWFWWWFFFWWWWWWFW
WFFFFFFFFWFFFFFWFFFWWFFFWFFFFFWFFFFFFFFW
WFWWWWWWWWFWWWWWWWFWWFWWWWWWWFWWWWWWWWFW
WFFFFFFFFFFFFFFFFFFFFFFFFFFFFFFFFFFFFFFW
WWWWWWWWWWWWWWWWWWWWWWWWWWWWWWWWWWWWWWWW
